7;7;3;5;1;1;5;5;6;6;1;6;2;2;1;7;5;1;1
5;0;1;5;9;4;6;2;1;7;6;9;4;0;2;5;6;2;0
3;9;9;3;4;2;0;2;8;0;5;7;0;7;8;5;6;5;1
3;8;0;3;4;5;8;8;6;2;4;6;0;5;1;1;8;2;6
4;3;2;6;0;7;2;8;1;1;5;4;5;8;9;8;4;1;0
3;8;9;6;7;2;0;8;4;4;7;9;8;7;1;2;4;7;4
3;6;5;8;8;0;5;1;5;2;8;1;3;0;6;1;9;1;7
7;7;9;3;0;8;5;7;5;2;0;1;8;8;5;9;7;8;2
6;6;8;5;6;6;6;9;5;0;0;9;9;3;8;1;0;6;1
4;1;5;1;3;5;0;3;3;4;3;0;1;2;4;3;2;9;3
5;8;6;9;8;1;4;7;5;1;5;4;8;3;3;2;8;4;3
3;3;3;8;6;3;0;0;9;5;0;0;3;6;8;1;2;1;3
5;9;2;0;7;8;5;6;6;2;5;5;1;6;8;2;9;3;4
0;1;4;7;3;4;4;4;2;0;4;4;2;6;3;0;2;5;1
